                ╔═══╗       ╔═══╗       ╔═══╗   ╔═══════╗                        
                ║   ║       ║   ║       ║   ║   ║       ║                        
                ║   ╚═══════╣   ╚═══════╣   ╚═══╩═══╗   ╚═══════════════╦═══╗    
                ║           ║           ║           ║                   ║   ║    
╔═══════════╗   ║   ╔═══╡   ╚═══╗   ╥   ╚═══╡   ╥   ╚═══════╡   ╔═══╡   ║   ╚═══╗
║           ║   ║   ║           ║   ║           ║               ║       ║       ║
║   ╥   ╞═══╣   ║   ╠═══════╗   ╨   ╠═══════════╩═══════╦═══════╣   ╞═══╩═══╡   ║
║   ║       ║   ║   ║       ║       ║                   ║       ║               ║
╚═══╩═══╗   ╚═══╣   ╨   ╥   ╚═══════╣   ╞═══════╦═══╗   ╨   ╥   ╚═══╦═══╡   ╔═══╝
        ║       ║       ║           ║           ║   ║       ║       ║       ║    
╔═══════╩═══╡   ║   ╔═══╩═══════╗   ╚═══╦═══╗   ╨   ╚═══════╬═══╗   ╚═══╦═══╝    
║               ║   ║           ║       ║   ║               ║   ║       ║        
╚═══╗   ╔═══════╝   ║   ╔═══╡   ╨   ╥   ╨   ╠═══════════╡   ║   ╠═══╡   ╠═══════╗
    ║   ║           ║   ║           ║       ║               ║   ║       ║       ║
╔═══╝   ║   ╔═══════╣   ╚═══════════╩═══╦═══╝   ╞═══════════╝   ║   ╥   ╨   ╔═══╝
║       ║   ║       ║                   ║                       ║   ║       ║    
║   ╞═══╣   ╚═══╡   ╠═══════════╦═══╗   ╨   ╔═══════╗   ╔═══════╣   ╚═══╦═══╝    
║       ║           ║           ║   ║       ║       ║   ║       ║       ║        
╚═══╗   ╚═══════╗   ║   ╞═══╗   ╨   ╚═══════╣   ╥   ╚═══╝   ╥   ╚═══╗   ╚═══════╗
    ║           ║   ║       ║               ║   ║           ║       ║           ║
    ║   ╞═══════╣   ╚═══╡   ║   ╔═══════╦═══╣   ╚═══╦═══════╩═══╗   ╠═══╡   ╥   ║
    ║           ║           ║   ║       ║   ║       ║           ║   ║       ║   ║
    ║   ╞═══╗   ╚═══════════╝   ║   ╥   ╨   ║   ╥   ╚═══════╗   ║   ║   ╞═══╬═══╝
    ║       ║                   ║   ║       ║   ║           ║   ║   ║       ║    
    ╚═══╗   ╚═══╦═══════════════╣   ╠═══════╩═══╩═══╗   ╥   ║   ║   ║   ╥   ║    
        ║       ║               ║   ║               ║   ║   ║   ║   ║   ║   ║    
        ╠═══════╝   ╔═══════╗   ╨   ╠═══╡   ╔═══╗   ╚═══╣   ║   ╨   ║   ║   ║    
        ║           ║       ║       ║       ║   ║       ║   ║       ║   ║   ║    
    ╔═══╝   ╔═══════╝   ╞═══╩═══════╝   ╔═══╝   ╠═══╡   ║   ╚═══╗   ╚═══╣   ║    
    ║       ║                           ║       ║       ║       ║       ║   ║    
    ╚═══╗   ╚═══╦═══════════╦═══════╗   ║   ╞═══╣   ╞═══╣   ╥   ╚═══╗   ╨   ║    
        ║       ║           ║       ║   ║       ║       ║   ║       ║       ║    
╔═══════╬═══╡   ║   ╞═══╗   ║   ╥   ║   ╚═══╗   ╚═══╡   ╚═══╩═══╡   ║   ╔═══╝    
║       ║       ║       ║   ║   ║   ║       ║                       ║   ║        
║   ╥   ║   ╞═══╩═══╡   ║   ╨   ║   ║   ╥   ║   ╞═══════╦═══╗   ╔═══╩═══╝        
║   ║   ║               ║       ║   ║   ║   ║           ║   ║   ║                
║   ║   ╨   ╔═══╦═══╡   ╠═══╦═══╝   ╠═══╝   ╠═══╦═══╡   ║   ║   ╚═══════╗        
║   ║       ║   ║       ║   ║       ║       ║   ║       ║   ║           ║        
╚═══╩═══════╝   ║   ╔═══╝   ╚═══╗   ╨   ╔═══╝   ╚═══╗   ║   ╠═══╡   ╔═══╝        
                ║   ║           ║       ║           ║   ║   ║       ║            
                ╚═══╝           ╚═══════╝           ╚═══╝   ╚═══════╝            