╔═══════════╗           ╔═══════╗           ╔═══╗       ╔═══╗                    
║S          ║           ║       ║           ║   ║       ║   ║                    
║   ╔═══╗   ║   ╔═══════╝   ╞═══╣   ╔═══╗   ║   ╚═══╗   ║   ║           ╔═══════╗
║   ║   ┋K  ║   ║  T            ║   ║   ║   ║       ║   ║   ║           ║       ║
╚═══╣   ╚═══╩═══╝   ╔═══════╡   ╠═══╝   ╠═══╩═══╡   ╠═══╝   ║   ╔═══════╝   ╔═══╝
    ║               ║     E     ║      K║           ║       ║   ║ K         ║    
    ╚═══════╦═══════╣   ╔═══╡   ╚═══╗   ╨   ╥   ╥   ╨   ╥   ╚═══╣   ╞═══════╣    
            ║       ║   ║        T  ║       ║   ║       ║       ║      K    ║    
    ╔═══════╝   ╔═┉═╝   ╠═══════╗   ║   ╔═══╝   ╠═══════╩═══╗   ╚═══╗   ╥   ╚═══╗
    ║           ║       ║   K  E║   ║   ║       ║           ║       ║   ║       ║
╔═══╩═┉═╦═══╡   ║   ╔═══╝   ╥   ║   ║   ║   ╔═══╩═══╡   ╥   ╠═══╡   ║   ║   ╔═══╝
║       ║       ║   ║       ║   ║   ║   ║   ║      T    ║   ║       ║   ║   ║    
╚═══╗   ║   ╔═══╝   ║   ╔═══╝   ║   ║   ║   ╠═══╡   ╔═══╝   ║   ╞═══╩═══╝   ║    
    ║   ║   ║       ║   ║       ║   ║   ║   ║       ║       ║               ║    
    ╚═══╣   ╠═══════╝   ║   ╔═══╝   ╚═══╣   ║   ╔═══╝   ╞═══╣   ╔═══════════╝    
        ║   ║           ║   ║           ║   ║   ║           ║  T║                
╔═══════╝   ║   ╔═══╦═══╣   ╠═══════╗   ╨   ║   ╚═══╦═══╗   ║   ╚═══════════╗    
║           ║   ║   ║   ┋   ║       ║       ║       ║   ║   ║               ║    
╚═══╗   ╥   ╨   ║   ║   ╚═══╣   ╥   ╠═══════╣   ╔═┉═╣   ╨   ╠═══╡   ╔═══════╝    
    ║   ║       ║   ║       ║   ║   ┋       ║ T ║   ║       ║T      ║            
╔═══╣   ╚═══════╝   ╚═══╗   ║   ╠═══╩═══╗   ║   ║   ╠═══════╣   ╔═══╝            
║   ║ E                 ║   ║   ║       ║   ║K  ║   ║       ║   ║                
║   ╚═══════════════╡   ║   ║   ║   ╞═══╩═══╝   ║   ╨   ╥   ╨   ╠═══════════╗    
║                       ║   ║   ║     T         ║       ║       ║           ║    
╚═══╗   ╔═══════════════╝   ║   ╚═══╦═══════════╣   ╞═══╩═══╦═══╝   ╔═══╗   ╚═══╗
    ║T  ║                   ║       ║           ║           ║       ┋   ║       ║
    ╚═══╣   ╥   ╔═══════════╩═══╗   ║   ╔═══╗   ╠═══╦═══╗   ║   ╞═══╣   ╚═══╦═══╝
        ║   ║   ║               ║   ║   ║T  ║   ┋   ║   ║   ║       ║  T   T║    
    ╔═══╝   ║   ║   ╔═══╗   ╥ K ║   ║   ║   ╚═══╣   ║   ╨   ╚═══════╩═══╗   ╚═══╗
    ║       ║   ║   ║  E║   ║   ║   ║   ║       ║   ║                   ║    K  ║
    ╚═══╗   ╚═══╣   ║   ║   ║   ║   ║   ║   ╞═══╣   ╚═══╦═══╦═══════╗   ╚═══╡   ║
        ║       ║   ║   ║   ║   ║   ║   ║       ║       ║   ║       ║           ║
    ╔═══╩═══╡   ║   ╨   ║   ║   ║   ╚═┉═╣   ╥   ╚═══╡   ║   ╨   ╥   ╠═══╡   ╔═══╝
    ║           ║       ║   ║   ║       ║   ║         T ║       ║   ║       ║    
    ║   ╞═══════╩═══╡   ║   ╠═══╬═══════╝   ╠═══════════╝   ╞═══╣ K ╨   ╞═══╬═══╗
    ║                   ║   ║   ┋           ║            K      ║           ║   ║
    ╚═══════════════╗   ║   ╨   ╠═══════════╝   ╞═══╦═══════╗   ╠═══╦═══╡   ╨   ║
                    ║   ║       ║                   ║       ║ T ║   ║  T       X║
                    ╚═══╩═══════╩═══════════════════╝       ║   ║   ╚═══╗   ╔═══╝
                                                            ║   ║       ║   ║    
                                                            ╚═══╝       ╚═══╝    